..............###########................
..............#.........#................
..............#.........#................
..............#.........#................
..............#.........#................
..............#.........#................
..............#############..............
........................#.#..............
........................#.#..............
........................#.#..............
............^############.#..............
..........................#..............
..........................#..............
..........................#..............
..........................#..............
..........................#..............
..........................#..............
..........................#..............
..........................#####..........
..............................#..........
..............................#...#######
..............................#...#.....#
..............................#...#.....#
..............................#...#.....#
..............................#...#.....#
..............................#...#.....#
..............................#...#.....#
..............................#...#.....#
....#######...................#...#.....#
..........#...................#...#.....#
..........#.............#####.###########
..........#.............#...#.....#......
..........#...........#############......
..........#...........#.#...#............
..........#...........#.#...#............
..........#...........#.#...#............
..........#...........#############......
..........#.............#...#.....#......
..........#.............#...#.....#......
..........#.............#...#.....#......
..........#############.#...#.....#......
......................#.#...#.....#......
............#############...#############
............#.........#...........#.....#
............#.........#...........#.....#
............#.........#...........#.....#
..........#############...........#.....#
..........#.#.....................#.....#
#############.....................#######
#.........#..............................
#.........#..............................
#.........#..............................
#.........#..............................
#.........#..............................
#.........#..............................
#.........#..............................
#.........#..............................
#.........#..............................
###########..............................


